111111111111111111111111111
100000000000000000000000001
100000000000000000000000001
100000000000000000000000001
1000000000000000000000N0001
100000000000000000000000001
100000000000000000000000001
100000000000000000000000001
100000000000000000000000001
100000000000000000000000001
100000000000000000000000001
100000000000000000000000001
100000000000000000000000001
100000000000000000000000001
100000000000000000000000001
100000000000000000000000001
100000000000000000000000001
111111111111111111111111111

2, 2, 10
2, 3, 11
2, 4, 12
2, 5, 20
