111111111111111111111111111
100000000000000000000000001
100000000000000000000000001
100000000000000000000000001
1000000000000000000000N0001
100000000000000000000000001
100000000000000000000000001
100000000000000000000000001
100000000000000000000000001
100000000000000000000000001
100000000000000000000000001
100000000000000000000000001
100000000000000000000000001
100000000000000011111111111
100000000000000010000100001
100000000000000030000300001
100000000000000010000100001
111111111111111111111111111

5, 7, 10
5, 8, 11
5, 9, 12
5, 10, 20
10, 10, 30
10, 15, 100
10, 15.5, 103
10, 16, 105
10, 16.5, 106
10, 17, 111
