111111111111111111111111111
100000000000000000000000001
100000000000000000000000001
100000000000000000000000001
1000000000000000000000N0001
100000000000000000000000001
100000000000000000000000001
100000000000000000000000001
100000000000000000000000001
100000000000000000000000001
100000000000000000000000001
100000000000000000000000001
100000000000000000000000001
100000000000000000000000001
100000000000000000000000001
100000000000000000000000001
100000000000000000000000001
111111111111111111111111111

5, 7, 10
5, 8, 11
5, 9, 12
5, 10, 20
