888888888884464464644464
800000000084000000000004
808800000884000000000006
800800000030000000000006
808800000884000000000004
800000000084000006660646
888808888884444446000006
777737777080808084040606
770000007808080886000006
700000000000000086000004
700000000000000086060606
770000007808080886460666
7777377778840684833303331
888808888464006063000003
880000088400000043000003
800000008400000043000003
100000001444446063300033
800000008881888660050505
880000088800088050500055
800000008000008505050505
100000000000000000000005
800000008000008505050505
880000088800088050500055
888818888881888555555555

20.5, 11.5, 10
18.5, 4.5, 10
10.0, 4.5, 10
10.0, 12.5, 10
3.5, 6.5, 10
3.5, 20.5, 10
3.5, 14.5, 10
14.5, 20.5, 10
18.5, 10.5, 9
18.5, 11.5, 9
18.5, 12.5, 9
21.5, 1.5, 8
15.5, 1.5, 8
16.0, 1.8, 8
16.2, 1.2, 8
3.5, 2.5, 8
9.5, 15.5, 8
10.0, 15.1, 8
10.5, 15.8, 8
