888888888888888888888888888888888888888811111
800000000000008000000000880000000000000300001
800N00000000088800000088880000000888888800001
888888888000000000131000000000008888888888888
800000000000000000101000000000000000000000008
888888888888888888808111111111118888888888838
100010000000003000080000000000000000000000101
100030000000001000000000000000000000000010001
111111111111111111111111111111111111111111111

3.5, 12, 10
4.5, 3, 103
2.5, 42, 111
1.5, 16, 105
6.5, 3, 49
4.5, 19.5, 11
1, 1, 12
6.5, 40, 10
7.5, 7.5, 10
5.5, 19.5, 106
7, 2.25, 10
7.5, 2.5, 10
